1111111111111111111111111111111111111111111111FFFFF111111111111
1.....1.................1.......1..1..........................1
1.......................1.......1..1...M.................N....1
1.M............1111111..1..1..111.....1111111111111111111111..1
1.....1........1.....1..1..1....1.....1.....1......1.......1..1
1.....1...111111.....1..1..1....1..1111.....1...M..1....M.....1
1111111...1....1.....1..1..111..1.....1..1..1...1..1..........1
1.........1...N1....N1..1..1....1.....1..1..1...1..1........N.1
1.........1..111...111..1..1....1111..1..1..1...1..1..111111111
1..1111...1................1..........1..1..1...1..1..........1
1..1..1...1M..............N1..........1..1..1...1..1..........1
1..1..1111111111111..111111111111111111..1..1...1..11111111...1
1..1.................1...................1..1...1..1......1...1
1..1....M............1...N...............1..1...1..1......1...1
1..1111111111111111..1..111111111111111111..1...1..11111..1...1
1.................1..1..1................1..1...1..1......11..1
1..........N..M...1..1..1.......N........1......1..1......1...1
11111111..111111..1111..1......11111111111......1..1..11111...1
1..............1........1M.....1.........1..11111..1......1...1
1..M........N..1........1.....N1........N.......1..1......1..N1
1..1..1111111..1..1111..1......1..M.............1..11111..1..11
1..1..1.....1..1..1.....1111..111111111111..1...1..1...1..1...1
1..1..1.....1..1..1.....1..1..1..1.......1..1...1..1...1..1...1
1..1111..1111..1..1..1111..1..1..1.......1..1...1..11..1..1...1
1..1.....1.....1..1.....1..1..1..1....1..1..1...1..1...1..1M..1
1..1.....1.....1..1.....1..1..1..1....1..1..1...1..1...1..11..1
1..1....111..111..111..1..1..1..1111111..1..1...1..1...1..1...1
1..111..1....1.......1..1..1..1.............1...1111..11..1...1
1..1....1....1.......1..1..1..1.............1..........1..1...1
1..1....1....1.......1..1..1..1..111111..1..1...N.M....1..1..N1
1..1..111....111..1111..1..1..1..1.......1..1...1111...1..1..11
1..1....1......1..1.....1..1..1..1.......1..1...1......1..1...1
1..1....1M.....1..1.....1..1..1..111111111..1...1......1..1...1
1..111..11111..1..1111111..1..1...1......1..1...1..11111..1...1
1..1........1..1..................1......1..1...1.........1M..1
1..1M.......1..1..M...............1......1..1...1.........11..1
1..1111111..1..11111111111111111111......1..1...11111111111...1
1..1........1...M........................1..1.................1
1..1.......N1...................N....11111..1......N..M.....N.1
1..1..1..1111..11111111111111111111..1......1.....1111..1.....1
1..1..1..1....................11..1..1......1.....1.....1.....1
1..1111..1.M..................11..1..1..11111111111.....1111111
1.M....N.1..1..1111111111111......1..1..1............1........1
1........1..1..1.....1.....1......1..1..1.M....1....N1.......N1
1111111111..1..1.....1.....11111111..1..11111..1..11111.......1
1...........1.....1.....1M...........1.........1......1..P....1
111111111111111111111111111111111111111111111111111111111111111