1111111111111111111111111111111111111111111111FFFFF111111111111
1.....1........11.....1....................1..................1
1...N.1...N....11.....1...N............N...1......M...........1
1..1..1..1111..11..1..1..1111..111..111111111111111111111111..1
1..1.....1..1..11..1..1..1.....1....1.............1.....1..1..1
1..1.....1..1..11..1..1..1.....1....1..N..M.......1.....1..1..1
1..1111111..1..11..1..1..1.....1..111..1111.......1..1........1
1........1..1......1..1..1.....1..1.......1.......1..1........1
1...M....1..1......1..1..1.....1..1.......111111111..1..1111..1
1111111..1..11111111..1..1.....1..1111111............1.....1..1
1.....1..1............1..1111..1..1.....1............1.....1..1
1.....1..1............1..1..1..1..1.....11111111111111111..1..1
1.....1..1..11111111111..1..1..1..1..................1.....1..1
1.....1..1..1............1..1..1..1............M.....1.....1..1
1...N.1..1..1............1..1..1..1.....11111111111..1..1111..1
1..1111..1..1..11111111111..1..1..1111111.........1..1...1.1..1
1..1.....1..1...1....1.........1........1.........1..1.....1..1
1..1.....1..1...1....1.........1........1..11111..1..1.1...1..1
1..1..1111..11..1.1.....1.111111111111..1..1...1..1..1111111..1
1..1..1......1..1.1.....1.1.............1..1...1....N.........1
1..1..1......1..11111111111.............1......1..........N...1
1..1..1......1............1.............1......1..1111111111111
1..1..1..M...1............1..1111111111111111111..1.....1.....1
1..1..11111..11111111111..1..1...1.....1..........1.....1.....1
1......................1..1..1.................N..1..1..1..1..1
1...N.....M............1..1..1.....N.1...1111111..1..1..1..1..1
1..111111111111..1111..1..1..1111..1111111.....1..1..1..1..1..1
1.............1..1..1..1..1.....1........1........1..1.M...1..1
1...........N.1..1..1..1..1.....1..M.....1..1.....1..1.....1..1
111111111111111.....1..1..1111..1111111..1111111111..1111111..1
1...........1.......1..1.....1........1.M.............1.......1
1...N...M...1.......1..1.....1........1...............1.....N.1
1..1111111..111..1111..1111..1111111..11111111111111111..111111
1..1.....1..1....1........1..1................................1
1..1...N.1..1....1........1..1.....M....................N.M...1
1..1..1111..1..111........1..1..111111111111..11111111111111..1
1..1.....1..1....1........1..1..1..........1..1............1..1
1..1.M...1..1....1111..1111..1..1..........1..1............1..1
1..1111..1..111..1..1..1.....1..1..111111111..1..11111111111..1
1..1.....1..1....1..1..1.....1.M....1......1..1............1..1
1..1...N.1..1....1..1..1....11......1......1..1............1..1
1..1..1111..1..111..1..1....111111111......1..11111111111..1..1
1..1........1.......1..1....1..............................1..1
1..1........1.......1..1.M..1..............................1..1
1..111111111111111111..111..11111111111111111111111111111111..1
1.............................................................1
1..M...........................................P..............1
111111111111111111111111111111111111111111111111111111111111111